SO ./textures/1.xpm
NO ./textures/2.xpm
EA ./textures/3.xpm
WE ./textures/4.xpm

C 0,250,154
F 100,149,237

        1111111111111111111111111
        1000000000110000000000001
        1011000001110000000000001
        1001000000000000000000001
111111111011000001110000000000001
100000000011000001110111110111111
11110111111111011100000010001
11110111111111011101010010001
11000000110101011100000010001
10000000000000001100000010001
10000000000000001101010010S01
1100000111010101111101111100111
11110111 1110101 101111010001
11111111 1111111 111111111111