SO ./textures/SO.xpm
NO ./textures/NO.xpm
EA ./textures/EA.xpm
WE ./textures/WE.xpm

C 202, 165, 237
F 163, 207, 98

        1111111111111111111111111
        1000000000110000000000001
        1011000001110000000000001
        1001000000000000000000001
111111111011000001110000000000001
100000000011000001110111110111111
11110111111111011100000010001
11110111111111011101010010001
11000000110101011100000010001
10000000000000001100000010001
10000000000000001101010010N01
1100000111010101111101111100111
11110111 1110101 101111010001
11111111 1111111 111111111111